WE ./images/magic_walls/magic_wall_w.png
NO ./images/magic_walls/magic_wall_n.png
SO ./images/magic_walls/magic_wall_s.png
EA ./images/magic_walls/magic_wall_e.png

F  220,100,0
C 225,30,0

111111
100101
100001
1100N1
111111
